R 1800 1300
NO ./textures/1.xpm
SO ./textures/2.xpm

WE ./textures/3.xpm
EA ./textures/4.xpm
S ./textures/sprite.xpm
F 33,4,6

C 208,233,250

                    1111111111111111111111111111111111111
                    1000000000000000011000000000000000001
                    1011000000000000111000000000000000001
                    1001000020000000000000000000000000001
111111111111111111111011000000000000111000000000000000001
120000000000000000000011000000000000111000111111111111111
111011111111111111111111111111110111000000000000000100001
111011111111111111111111111111110111000000000000000100001
110000000000000001101211111111110111000002000000000100001
100000000200000001101011111111110111000000000000000100001
100000000000000000000000000000000000000000000000000000001
100000011111100000000000000000000000000000000000000000001
10000001    100000002000000000000000000000002000002000001
11000001    10000000000E000000000000000000000000000000001
11100001    100000000000000000000000000000000000000000001
111100011111111111111111111111111111111111111111111111111
11110000111
11110220111
11111111111
