R 1800 1300
NO ./textures/1.xpm
SO ./textures/2.xpm

WE ./textures/3.xpm
EA ./textures/4.xpm
S ./textures/sprite.xpm
F 33,4,6

C 208,233,250

11111111111111111111111111
1020000000E000000020002001
10002210000000000011100001
11111111111111111111111111
