

R 1920      1080    
NO ./textures/1.xpm     
SO                  ./textures/4.xpm

WE      ./textures/3.xpm
EA ./textures/2.xpm


S        ./textures/sprite.xpm
F     220,100,0

C 225,30,0  



        1111111111111111111111111
        1000000000110000000000021
        1011000001110000002000001
        1001200000000000000000001
111111111011000001110000000000001
100000000011000001110111111111111
11110111111111011100000012001
11110111111111011101010000001
11000000110101011100000010001
10002000000000000000000010001
10000000000020001101010010001
11000021110101011111011110N0111
11110111 1110101 101111010001
11111111 1111111 111111111111
