R 1920 1080
NO ./textures/1.xpm
SO ./textures/2.xpm
WE ./textures/3.xpm
EA ./textures/4.xpm
S ./textures/sprite.xpm
F 220,100,0
C 225,30,0
111
101
111

111111
100101
102001
1100N1
111111
